%%%%%%%%%%%%%%%%%%%%%%%%%%%%%%%%%%%%%%%%%%%%%%%%%%%%%%%%%%%%%%%%%%%%%%%%%%%%%%%%%
%P####  %#######%###% %     %   %   %   %             % %   %         %     %   %
%   %#%%%#% %%%#%#%#% % % %%% % % % % %%% %%% %% %%%% % % % % % %%%%% % %%% %%% %
%   %#####% % %###%#%   %   % % % % % %   % % %     % %   %   %     %   % %     %
%%% %%%% %% % %  %%#%% %% % %%% % % % % %%% % %%%%% % % %%%%% %   % % %%% % % % %
%   % %     %     %#    % %   %   % % %     %     % % %     %   %       %   % % %
%   % % % %   % % %#    % % % %%% % % %%%%% %%%%% % % %%%%% % % % %%% % %%% % %%%
% %   % % %   % % %###  %   %     % %       %     % %     %   % %     %   %     %
% %%% % %%% % %%% % %# %% %%% %%% % %% %%%% % %%%%% %     % %   %% %% %%% % %%% %
% %       % % %   % %###% %#####% %     %     %#########  % %       % %   % %   %
% % %%%%% % % % %%% % %#%%%#%%%#% %%    % %%%%%#%%% %%%#%%% % %%%%% %%% %%% % % %
%   %   %   % %     % %#####%###        % %   %#% %   %#### %     %     %   % % %
% % %%% %%%%% % % %%% % % %%%#%%%%%%% %%% % %%%#% %%% % %%#%%%%  ###   %% %%% % %
% %         % % %   % %   % %#%       %   % ####  % %   % ########%##   %   % % %
% % %%% %%%%% % %%% % %%%%% %#% %%%%%%%%% %%#%%%% % %%%%% %% %%%%%%%#%% %%% % %%%
%   %   %     %   %   %      #%    #####%   ##  %   %   % %   %     ###   % %   %
%%% % %%% %%%%% %%%%%%% %%% %#   %%#%%%#%%%%%#% %%% % %       % % %%%%#%%%% %%% %
%       % %           % %   %#######  %#######  % %   %   % % % %   % ####% %   %
% %%%%%%% % %%%%% %%% % %%% % %%%%%%% %%%%%%%%%%% %%% %%% % % % %%% % %%%#% % %%%
%         %     %   % %   % %   %   %   %   %     %     %   %   % %     %#% %   %
%%%%% % %%%%%   %%% % %%% % %%% %%%     % % %%% % % %%% % %%%%%%% %%% %%%#% % % %
%     %   %   %   % % %   %   %           %     %   %   %         %   %###% % % %
% %%%%%%% % % % % % % % %%% % %%%%% % %%%%%%% %%%%%%% %%%%%%% %%% %%% %#%%% % % %
%       % % %   % % % % %   %     % %       % %   %   %   %     %   % %###% % % %
%%% %% %% % %%%%% % %%% % % %  %% % %%%% %% %%% % %%%%% % % % % %%% % %%%#% %%% %
%         %   %   %   % % % %   % %       %     %       % % % %   % %   %#%     %
% %%%%    %%% % %%% % % %%% %%% % % %%% % % % %%% % %%%%% % %     % % % %#%%%%% %
%   %     %   % %   %       %   %   %   % % %   % % %     % %     % % % %#####% %
% % %%% %%% %%% %% %%%%%%%%%% %%%%%%% %%% % %%% % % %%% % % % %%%%% %%% %%%%%#% %
% %           %                       %   %     %       %   %               %##.%
%%%%%%%%%%%%%%%%%%%%%%%%%%%%%%%%%%%%%%%%%%%%%%%%%%%%%%%%%%%%%%%%%%%%%%%%%%%%%%%%%
