%%%%%%%%%%%%%%%%%%%%%%%%%%%%%%%%%%%%%
%                     %P            %
%                     %#            %
%                     %#            %
%                     %#            %
%                     %######       %
%                     %%%%%%#       %
%                          %#       %
%                          %#       %
%                          %#       %
%                          %#       %
%       ##############     %#       %
%       #%%%%%%%%%%%%########       %
%       #%                          %
%       #%                          %
%       #%                          %
%       #%                          %
%       #%                          %
%       #.%                         %
%%%%%%%%%%%%%%%%%%%%%%%%%%%%%%%%%%%%%
