%%%%%%%%%%%%%%%%%%%%%%%%%%%%%%%%%%%%%%%%%%%%%%%%%%%%%%%%%%%%%
%         % %           %     %     ####  %###########%####.%
% %%%% %% % % %%%%% %%%%% %%% % %%%%#%%#%%%#%% %% %%%#%#% % %
% %     %   %     %       %   %  #### %#####%   % % %###% % %
% % %%% % %%%% %% %%%%%%%%% %%%%%#%%% % %%% % % % % %%%%% % %
% %   %   %       %       %   ####%   %   % % % %     %   % %
% % %%% %%% %%% %%% % %%% %%%%#%% % %%% % %%% % %%% %%% %%% %
%   %     %     %   % %######## % % %   %     %   % %   % % %
% %%% %%% %%%%% %%%%% %#%%% %%% %%%%% %%%%%% %%%% %%% %%% % %
%     %#######%    #####% % %         %   %     %     %   % %
% %%%%%#%%%%%#%%%%%#%%% % % % %%%%%%%%% % % %%% %%% %%% %%% %
% %   %#%   %#######  % %   % %     %   % % %           %   %
% % %%%#% %%% %%%%% % % %%%%% % % %%% % % %%% %%%%% %%%%% %%%
%   %###% %       % % %   %   % %   % % %     %     %   % % %
% %%%#%%% % % %%% %%% %%% % %%% %%% % % %%%%%%%%% %%% % % % %
% %###%   % %   %   % %   % %     %   %   %     % %   %   % %
%###%%% % % % % % % % % %%% % %%%%%%% %%% % %%% % % %%%%%%% %
%#%   % %   % %   %   % %                 % %   % % %       %
%#%%% %%% %%% %%% % %%% % %%% % %%%%%% %%%% % %%%%% % % %%% %
%###%         %   % %   % %   %         %   % %     % % %   %
%%%#%%% % %%%%% %%%%% %%%%% %%% %%%%%%% % %%% % %%%%%%% % %%%
%P##  %       %             %         %     %           %   %
%%%%%%%%%%%%%%%%%%%%%%%%%%%%%%%%%%%%%%%%%%%%%%%%%%%%%%%%%%%%%
